11111111111111111111
1P000000000000000001
100000000000000000E1
10000000000000000001
10111111111111111111
100C0000000000000001
11111111111111111111
